###############
#     @       #
#             #
#             #
#             #
#             #
#             #
#             #
#             #
#         x   #
#             #
#             #
#             #
#             #
###############